9 46
255 1750 1
2 2 2 2 5 2 2 2 2
2 0 0 0 0 0 0 0 2
2 0 0 0 6 0 0 0 2
2 0 0 0 0 0 0 0 2
2 0 0 4 0 0 0 0 2
2 0 0 0 0 0 0 0 2
2 0 0 0 0 4 0 0 2
2 0 4 0 0 0 0 0 2
2 0 0 0 0 0 4 0 2
2 0 0 4 0 0 0 0 2
2 0 0 0 0 0 0 0 2
2 0 0 0 0 0 0 0 2
2 0 4 0 4 0 0 0 2
2 0 0 0 0 0 0 0 2
2 0 0 0 0 0 0 0 2
2 0 4 0 0 0 4 0 2
2 0 0 0 0 0 0 0 2
2 0 4 0 4 0 0 0 2
2 0 0 0 0 0 0 0 2
2 0 0 0 4 0 0 0 2
2 0 0 0 0 0 4 0 2
2 0 4 0 4 0 0 0 2
2 0 4 0 4 0 0 0 2
2 0 4 0 0 0 0 0 2
2 0 0 0 0 0 0 0 2
2 0 4 0 0 0 0 0 2
2 0 0 0 0 0 0 0 2
2 0 0 0 0 0 0 0 2
2 0 4 0 4 0 0 0 2
2 0 0 0 0 0 0 0 2
2 0 0 0 0 4 0 0 2
2 0 0 0 0 0 0 0 2
2 0 0 4 0 0 0 0 2
2 0 0 0 0 0 0 0 2
2 0 0 0 0 4 0 0 2
2 0 0 0 0 0 0 0 2
2 0 0 0 0 0 0 0 2
2 0 0 0 0 0 0 0 2
2 0 0 0 0 0 0 0 2
2 0 0 0 5 0 0 0 2
2 0 0 6 0 0 0 0 2
2 0 0 0 0 0 0 0 2
2 0 0 0 0 0 0 0 2
2 0 0 0 3 0 0 0 2
2 0 0 0 0 0 0 0 2
2 0 0 0 0 0 0 0 2
2 2 2 2 2 2 2 2 2