9 56
255 1750 2
2 2 2 2 5 2 2 2 2
2 0 0 0 6 0 0 0 2
2 0 0 0 0 0 0 0 2
2 0 0 0 0 0 0 0 2
2 0 0 0 0 0 0 0 2
2 0 0 0 0 0 0 0 2
2 0 0 0 0 0 0 0 2
2 0 0 0 4 0 0 0 2
2 0 0 0 0 0 0 0 2
2 0 0 0 0 0 0 0 2
2 0 4 0 0 0 0 0 2
2 0 0 0 4 0 0 0 2
2 0 0 0 0 0 0 0 2
2 0 0 0 0 4 0 0 2
2 0 0 0 0 0 0 0 2
2 0 0 0 0 0 4 0 2
2 0 0 0 0 0 0 0 2
2 0 0 0 0 0 0 0 2
2 0 0 0 0 0 0 0 2
2 0 0 0 0 0 0 0 2
2 0 0 0 0 0 0 0 2
2 0 0 4 0 0 4 0 2
2 0 0 0 0 0 0 0 2
2 0 0 0 0 0 0 0 2
2 0 0 0 0 0 0 0 2
2 0 4 0 4 0 0 0 2
2 0 0 0 0 0 0 0 2
2 0 0 0 0 0 0 0 2
2 0 0 0 0 0 0 0 2
2 0 0 0 0 0 0 0 2
2 0 0 0 0 0 0 0 2
2 0 4 0 0 4 0 0 2
2 0 0 0 0 0 0 0 2
2 0 0 0 0 0 0 0 2
2 0 0 0 0 0 0 0 2
2 0 0 4 0 0 0 0 2
2 0 0 0 0 0 0 0 2
2 0 0 0 0 0 0 0 2
2 0 0 0 0 0 0 0 2
2 0 0 0 0 0 0 0 2
2 0 0 4 0 0 0 0 2
2 0 0 0 0 0 0 0 2
2 0 0 0 0 0 0 0 2
2 4 0 0 0 0 4 0 2
2 0 0 0 0 0 0 0 2
2 0 0 0 0 0 0 0 2
2 0 0 0 0 0 0 0 2
2 0 0 0 0 0 0 0 2
2 0 0 0 0 0 0 0 2
2 0 0 0 0 0 0 0 2
2 0 4 0 0 0 4 0 2
2 0 0 0 0 0 0 0 2
2 0 0 0 0 0 0 0 2
2 0 0 0 3 0 0 0 2
2 0 0 0 0 0 0 0 2
2 0 0 0 0 0 0 0 2
2 2 2 2 2 2 2 2 2
